{ "map":[["X","X","X","X","X","X","X","X","X","X","X","X","X","X","X","X","X","X","X","X","X","X","X","X","X","X","X","X","X","X","X","X"],
        ["X"," "," "," "," "," "," "," "," "," "," "," "," "," "," "," "," "," "," "," "," "," "," "," "," "," "," "," "," "," "," ","X"],
        ["X"," "," ","E"," "," "," "," "," "," "," "," "," "," "," ","E"," "," "," "," "," "," "," "," "," "," "," "," "," "," "," ","X"],
        ["X"," "," "," "," "," "," "," "," "," "," "," "," "," "," "," "," "," "," "," "," "," "," "," "," "," "," "," "," ","E"," ","X"],
        ["X"," "," "," ","X","X","X","X","X","X","X","X"," "," "," "," "," "," "," "," ","X","X","X","X","X","X","X","X"," "," "," ","X"],
        ["X"," "," "," ","X"," ","E"," "," "," "," ","X"," "," "," "," "," "," "," "," "," "," "," "," "," "," "," ","X"," "," "," ","X"],
        ["X"," "," "," ","X"," "," "," "," "," "," ","X"," "," "," "," "," "," "," "," "," "," "," ","E"," "," "," ","X"," "," "," ","X"],
        ["X"," "," "," ","X"," "," "," "," "," "," ","X"," "," "," "," "," "," ","E"," "," "," "," "," "," "," "," ","X"," "," "," ","X"],
        ["X"," "," "," ","X"," "," "," "," "," "," ","X"," "," "," "," "," "," "," "," "," "," "," "," "," "," "," ","X"," "," "," ","X"],
        ["X"," "," "," ","X"," "," "," "," "," "," ","X"," "," "," "," "," "," "," "," "," "," "," "," "," "," "," ","X"," "," "," ","D"],
        ["X"," "," "," ","X"," "," "," "," "," "," ","X","X","X","X","X","X"," "," "," "," "," "," "," "," "," "," ","X"," "," "," ","D"],
        ["X"," "," "," ","X"," "," "," "," "," "," "," ","X"," "," "," ","X"," "," "," "," ","E"," "," "," ","X"," ","X"," "," "," ","D"],
        ["X"," "," "," ","X"," "," "," "," "," "," "," ","X"," "," "," ","X"," "," "," "," "," "," "," "," ","X"," ","X"," "," "," ","X"],
        ["X"," "," "," ","X"," "," "," ","E"," "," "," ","X"," "," ","E","X"," "," "," "," "," "," "," "," ","X"," ","X"," ","E"," ","X"],
        ["X"," "," "," ","X"," "," "," "," "," "," "," ","X"," "," "," ","X"," "," "," "," "," "," "," "," ","X"," ","X"," "," "," ","X"],
        ["X"," "," "," ","X"," "," "," "," "," "," "," ","X"," "," "," ","X"," "," "," "," "," "," "," "," ","X"," ","X"," "," "," ","X"],
        ["X"," ","E"," ","X"," "," "," "," "," "," "," ","X","X","X"," ","X"," "," "," "," "," "," "," "," ","X"," ","X"," "," "," ","X"],
        ["X"," "," "," "," "," "," "," "," "," "," "," "," "," "," "," ","X"," "," "," "," "," ","E"," "," "," "," ","X"," "," "," ","X"],
        ["X"," "," "," "," "," ","X","X","X"," "," "," "," ","E"," "," ","X"," "," "," "," "," "," "," "," "," "," ","X"," "," "," ","X"],
        ["X"," "," "," "," "," ","X"," "," ","X"," "," "," "," "," "," ","X"," "," "," "," "," "," "," "," "," "," ","X"," ","E"," ","X"],
        ["X","X","X","X","X","X","X"," "," "," ","X"," "," "," "," "," ","X","X","X","X","X","X","X","X","X","X","X","X"," "," "," ","X"],
        ["X"," "," "," "," "," "," "," "," "," "," "," "," "," "," "," "," "," "," "," "," "," "," "," "," "," "," ","X"," "," "," ","X"],
        ["X","P"," "," "," "," "," "," "," "," "," "," "," "," "," "," "," ","E"," "," "," "," "," "," "," "," "," ","X"," "," "," ","X"],
        ["X","X","X","X","X","X","X","X","X","X","X","X","X","X","X","X","X","X","X","X","X","X","X","X","X","X","X","X","X","X","X","X"]]
}