{ "mapa": [["X","X","X","X","X","X","X","X","X","X","X","X","X","X","X","X","X","X","X","X","X","X","X","X","X","X","X","X","X","X","X","X"],
        ["X"," "," "," "," "," "," "," "," "," "," "," "," "," "," "," "," "," "," "," "," "," "," "," "," "," "," "," "," "," "," ","X"],
        ["X"," "," "," "," "," "," "," "," "," "," "," "," "," "," "," "," "," "," "," "," "," "," "," "," "," "," "," "," "," "," ","X"],
        ["X"," "," "," "," "," "," "," "," "," "," "," "," "," "," "," "," "," "," "," "," "," "," "," "," "," "," "," "," "," "," ","X"],
        ["X"," "," "," ","X","X","X","X","X","X","X","X"," "," "," "," "," "," "," "," ","X","X","X","X","X","X","X","X"," "," "," ","X"],
        ["X"," "," "," ","X"," "," "," "," "," "," "," "," "," "," "," "," "," "," "," "," "," "," "," "," "," "," ","X"," "," "," ","X"],
        ["X"," "," "," ","X"," "," "," "," "," "," "," "," "," "," "," "," "," "," "," "," "," "," "," "," "," "," ","X"," "," "," ","X"],
        ["X"," "," "," ","X"," "," "," "," "," "," "," "," "," "," "," "," "," "," "," "," "," "," "," "," "," "," ","X"," "," "," ","X"],
        ["X"," "," "," ","X"," "," "," "," "," "," "," "," "," "," "," "," "," "," "," "," "," "," "," "," "," "," ","X"," "," "," ","X"],
        ["X"," "," "," ","X"," "," "," "," "," "," "," "," "," "," "," "," "," "," "," "," "," "," "," "," "," "," ","X"," "," "," ","X"],
        ["X"," "," "," ","X"," "," "," "," "," "," "," ","X","X","X","X","X"," "," "," "," "," "," "," "," "," "," ","X"," "," "," ","X"],
        ["X"," "," "," ","X"," "," "," "," "," "," "," ","X"," "," "," ","X"," "," "," "," "," "," "," "," "," "," ","X"," "," "," ","X"],
        ["X"," "," "," ","X"," "," "," "," "," "," "," ","X"," "," "," ","X"," "," "," "," "," "," "," "," "," "," ","X"," "," "," ","X"],
        ["X"," "," "," ","X"," "," "," "," "," "," "," ","X"," "," "," ","X"," "," "," "," "," "," "," "," "," "," ","X"," "," "," ","X"],
        ["X"," "," "," ","X"," "," "," "," "," "," "," ","X"," "," "," ","X"," "," "," "," "," "," "," "," "," "," ","X"," "," "," ","X"],
        ["X"," "," "," ","X"," "," "," "," "," "," "," ","X"," "," "," ","X"," "," "," "," "," "," "," "," "," "," ","X"," "," "," ","X"],
        ["X"," "," "," ","X"," "," "," "," "," "," "," ","X","X","X"," ","X"," "," "," "," "," "," "," "," "," "," ","X"," "," "," ","X"],
        ["X"," "," "," "," "," "," "," "," "," "," "," "," "," "," "," ","X"," "," "," "," "," "," "," "," "," "," "," "," "," "," ","X"],
        ["X"," "," "," "," "," "," "," "," "," "," "," "," "," "," "," ","X"," "," "," "," "," "," "," "," "," "," "," "," "," "," ","X"],
        ["X"," "," "," "," "," "," "," "," "," "," "," "," "," "," "," ","X"," "," "," "," "," "," "," "," "," "," "," "," "," "," ","X"],
        ["X","X","X","X","X"," "," "," "," "," "," "," "," "," "," "," ","X","X","X","X","X","X","X","X","X","X","X","X"," "," "," ","X"],
        ["X"," "," "," ","X"," "," "," "," "," "," "," "," "," "," "," "," "," "," "," "," "," "," "," "," "," "," ","X"," "," "," ","X"],
        ["X"," "," "," ","X"," "," "," "," "," "," "," "," "," "," "," "," "," "," "," "," "," "," "," "," "," "," ","X"," "," "," ","X"],
        ["X"," "," "," ","X"," "," "," "," "," "," "," "," "," "," "," "," "," "," "," "," "," "," "," "," "," "," ","X"," "," "," ","X"],
        ["X"," "," "," ","X"," "," "," "," "," "," "," "," "," "," "," "," "," "," "," "," "," "," "," "," "," "," ","X"," "," "," ","X"],
        ["X"," "," "," ","X"," "," "," "," "," "," "," "," "," "," "," "," "," "," "," "," "," "," "," "," "," "," ","X"," "," "," ","X"],
        ["X"," "," "," ","X","X","X","X","X","X","X","X","X","X"," "," "," "," "," "," "," ","X","X","X","X","X","X","X"," "," "," ","X"],
        ["X"," "," "," "," "," "," "," "," "," "," "," "," "," "," "," "," "," "," "," "," ","X"," "," "," "," "," "," "," "," "," ","X"],
        ["X"," "," "," "," "," "," "," "," "," "," "," "," "," "," "," "," "," "," "," "," "," "," "," "," "," "," "," "," "," "," ","X"],
        ["X","X","X","X","X","X","X","X","X","X","X","X","X","X","X","X","X","X","X","X","X","X","X","X","X","X","X","X","X","X","X","X"]]
}