XXXXXXXXXXXXXXXXXXXXXXXXXXXXXXXX
X..............................X
X..............................X
X..............................X
X...XXXXXXXX........XXXXXXXX...X
X...X......................X...X
X...X......................X...X
X...X......................X...X
X...X......................X...X
X...X......................X...X
X...X.......XXXXX..........X...X
X...............X..............P
X...............X..............P
X...............X..............P
XXXXX...........XXXXXXXXXXXX...X
X...X......................X...X
X...X......................X...X
X.J.X......................X...X
X...X......................X...X
X...X......................X...X
X...XXXXXXXXXX.......XXXXXXX...X
X..............................X
X..............................X
XXXXXXXXXXXXXXXXXXXXXXXXXXXXXXXX
