{ "map":[["X","X","X","X","X","X","X","X","X","X","X","X","X","X","X","X","X","X","X","X","X","X","X","X","X","X","X","X","X","X","X","X"],
    ["X"," "," "," "," "," "," "," "," "," "," "," "," ","X"," "," "," "," "," "," "," "," "," "," "," "," "," "," "," "," "," ","X"],
    ["X","E"," "," "," "," "," "," "," "," "," ","E"," ","X"," "," "," "," "," "," "," "," "," "," "," "," "," "," "," "," ","E","X"],
    ["X"," "," "," "," "," "," "," "," "," "," "," "," ","X"," "," "," ","E"," "," "," "," "," "," "," "," "," "," "," "," "," ","X"],
    ["X"," "," "," ","X","X","X","X","X","X"," "," "," ","X"," "," "," "," "," "," ","X","X","X","X","X","X","X","X"," "," "," ","X"],
    ["X"," "," "," ","X"," "," "," "," ","X"," "," "," ","X"," "," "," "," "," "," "," "," "," "," "," "," "," ","X"," "," "," ","X"],
    ["X"," "," "," ","X"," "," "," "," ","X"," "," "," ","X"," "," "," "," "," "," "," "," "," "," "," "," ","E","X"," "," "," ","X"],
    ["X"," "," "," ","X"," "," "," "," ","X"," "," "," ","X"," "," "," "," "," "," "," "," "," "," "," "," "," ","X"," "," "," ","X"],
    ["X"," "," "," ","X"," "," "," "," ","X"," "," "," ","X"," "," "," "," "," "," "," "," "," "," "," "," "," ","X"," "," "," ","X"],
    ["X"," "," "," ","X"," "," "," "," ","X"," "," "," ","X"," "," "," "," "," "," "," "," "," "," "," "," "," ","X"," "," "," ","X"],
    ["X"," "," "," ","X"," "," "," ","P","X"," "," ","E","X"," "," "," "," "," "," "," "," "," "," "," "," "," ","X"," "," "," ","X"],
    ["X"," "," "," ","X"," "," "," "," ","X"," "," "," ","X","X","X","X"," "," "," "," "," "," "," ","E"," "," ","X"," "," "," ","X"],
    ["X"," "," ","E","X"," "," "," "," ","X"," "," ","X"," "," "," ","X"," "," "," "," "," "," "," "," "," "," ","X"," "," "," ","X"],
    ["X"," "," "," ","X"," "," "," "," ","X"," ","X"," "," ","E"," ","X"," ","X","X","X","X"," "," "," "," "," ","X"," "," "," ","X"],
    ["X"," "," "," "," "," ","X","X","X","X"," ","X"," "," "," "," ","X"," "," "," "," ","X"," "," "," "," "," ","X"," "," ","E","X"],
    ["X"," "," "," "," "," ","X"," "," "," "," ","X"," "," "," "," ","X"," "," ","E"," ","X","X","X","X","X","X","X"," "," "," ","X"],
    ["X","X","X","X","X"," ","X"," "," "," "," ","X"," "," "," "," ","X"," "," "," "," "," "," "," "," "," "," ","X"," "," "," ","X"],
    ["X"," "," "," ","X","X","X"," "," "," "," ","X"," "," "," "," ","X"," "," "," "," "," "," "," "," "," ","E","X"," "," "," ","X"],
    ["X"," ","E"," "," "," "," "," "," "," "," ","X"," "," "," "," ","X"," "," "," "," "," "," "," "," "," "," ","X"," "," "," ","X"],
    ["X"," "," "," "," "," "," "," ","X","X","X","X"," "," "," "," ","X"," "," "," "," "," "," "," "," "," "," ","X"," "," "," ","X"],
    ["X"," "," "," ","X","X","X","X","X"," ","E"," "," "," "," "," ","X","X","X","X","X","X","X","X","X"," "," ","X","D","D","D","X"],
    ["X"," "," "," ","X"," "," "," "," "," "," "," "," "," "," "," "," "," "," "," "," "," "," "," "," "," "," ","X"," "," "," ","X"],
    ["X"," "," "," "," "," "," "," "," "," "," "," "," "," "," "," "," "," "," "," "," "," "," "," "," "," "," ","X"," "," "," ","X"],
    ["X","X","X","X","X","X","X","X","X","X","X","X","X","X","X","X","X","X","X","X","X","X","X","X","X","X","X","X","X","X","X","X"]]
}