{ "map":[["X","X","X","X","X","X","X","X","X","X","X","X","X","X","X","X","X","X","X","X","X","X","X","X","X","X","X","X","G","G","X","X"],
    ["X"," "," "," "," "," "," "," "," "," "," "," "," ","X"," "," "," ","X"," "," "," "," "," "," "," "," "," "," "," "," "," ","X"],
    ["X"," "," "," ","E"," "," "," "," "," "," "," "," ","X"," "," "," ","X"," "," "," "," "," "," "," "," "," "," "," "," "," ","X"],
    ["X"," "," "," "," "," "," "," "," "," "," "," "," ","X"," "," "," "," ","X"," "," "," "," "," "," "," "," "," "," "," "," ","X"],
    ["X"," "," "," "," "," "," "," "," ","X"," "," "," ","X"," "," "," "," "," ","X","X","X","X","X","X","X","X","X"," "," "," ","X"],
    ["X"," "," "," "," "," "," "," "," ","X"," "," "," ","X"," "," "," "," "," "," "," "," "," "," "," "," "," ","X"," "," "," ","X"],
    ["X"," "," "," "," "," "," "," "," ","X"," "," "," ","X"," "," "," "," "," "," "," "," "," "," "," "," "," ","X"," "," "," ","X"],
    ["X"," "," "," "," "," "," "," "," ","X"," "," "," ","X"," "," "," ","X","X","X","X","X"," "," "," "," "," ","X"," "," "," ","X"],
    ["X"," "," "," "," "," "," "," "," ","X"," "," "," ","X"," "," "," ","X"," "," "," "," ","X"," "," "," "," ","X"," "," "," ","X"],
    ["X"," "," "," ","X"," "," "," "," "," "," "," "," ","X"," "," "," ","X"," "," "," "," "," "," "," "," "," ","X"," "," "," ","X"],
    ["X"," "," "," ","X"," "," "," "," "," "," "," ","E","X"," "," ","X","X"," "," "," "," "," "," "," "," "," ","X"," "," "," ","X"],
    ["X"," "," "," ","X"," "," "," "," ","X","X","X","X","X"," "," ","X"," "," "," "," "," "," "," ","E"," "," ","X"," "," "," ","X"],
    ["X"," "," ","E","X"," "," "," "," ","X"," "," ","X"," "," "," ","X"," "," "," "," "," "," "," "," "," ","X","X"," "," "," ","X"],
    ["X"," "," "," ","X"," "," "," "," ","X"," ","E"," "," ","E"," ","X"," "," ","X","X","X"," "," "," "," ","X","X"," "," "," ","X"],
    ["X"," "," "," "," "," ","X","X","X","X"," "," "," "," "," "," ","X"," "," "," "," ","X"," "," "," ","X","X","X"," "," ","E","X"],
    ["X"," "," "," "," "," ","X","X","X","X"," "," "," "," "," "," ","X"," "," ","E"," ","X","X","X","X","X","X","X"," "," "," ","X"],
    ["X","X"," "," ","X","X"," "," "," "," "," "," "," "," "," "," ","X"," "," "," "," "," "," "," "," "," "," ","X"," "," "," ","X"],
    ["X"," "," "," ","X","X"," "," "," "," "," "," "," "," "," "," ","X"," ","E"," "," "," "," "," "," "," ","E","X"," "," "," ","X"],
    ["X"," ","E"," "," "," "," "," ","X","X"," "," "," "," "," "," ","X"," "," "," "," "," "," "," "," "," "," ","X"," "," "," ","X"],
    ["X"," "," "," "," "," "," "," ","X","X"," "," "," "," "," "," ","X"," "," "," "," "," "," "," "," "," "," ","X"," "," "," ","X"],
    ["X"," "," "," ","X","X","X","X","X"," "," "," "," "," "," "," ","X","X","X","X","X","X","X","X","X"," "," "," "," "," "," ","X"],
    ["X"," "," "," "," "," "," "," "," "," "," "," "," "," "," "," "," "," "," "," "," "," "," "," ","X"," "," "," "," "," "," ","X"],
    ["X"," "," "," "," "," "," "," "," "," "," "," "," ","X"," "," "," ","X"," "," "," "," "," "," "," "," "," "," "," "," "," ","X"],
    ["X","X","X","X","X","X","X","X","X","X","X","X","X","X","X","X","X","X","X","X","X","X","X","X","X","X","X","X","X","X","X","X"]]
}
